1111111111111
1C010000000C1
10010000000C1
10010000000C1
10010000000C1
10010000000C1
10010000000C1
10010000000C1
10010000000C1
10010000000C1
10010000000C1
10010000000C1
10010000000C1
1000000000001
1000011111VV1
1P0000E000001
1111111111111